11111111111111111111111111111
1C00E00C00C00P000011000110001
100010001010000000X0010101011
10000000011000011000000100001
100011001100X0010100100100001
11000110100001000110000000001
10110000011110101001101001001
11110000001010000000000000001
11000000110000010001010000101
11000000010100100000011010001
1000X000000110000000110011001
10100010000101011010001001001
11110000010100010100000000001
10001000011000000000101101001
11100100001100010100001010001
10000010000111100000000101011
10100100001111011000001000001
10100010000000001110100001001
11000000010101011011010100001
1100X100100000000101000000101
10010001000000000000010011101
10001001110000100000100000001
10011010110100010000001010101
1100001000000100000X000010001
10110101000000100000110100011
11110001010001100010000000101
10001000000000010000000001001
10100001001010101001101100011
10010011001111000000001010101
11111111111111111111111111111
