11111111111111111111111111111
1PPPFPPPPPPPPPPPPP11000110001
10001PPP1P1PPPPPPPPPP10101011
100PPPPPP11PPPP11000PPP100001
10PP11PP11PPPPP1P1001PP100001
11PPP11P1PPPP1PPP1100PPPPPPP1
1011PPPPP111101P1001101PP1PP1
1111PPPPPP101PPPPPPPPPPPPPPP1
11PPPPPP11PPPPP1000101PPPP1P1
11PPPPPPP1P10010000001101PPP1
1PPPPPPPPPP110000000110011001
1P100010000101011010001001001
11110000010100010100000000001
10001000011000000000101101001
11100100001100010100001010001
10000010000111100000000101011
10100100001111011000001000001
10100010000000001110100001001
11000000010101011011010100001
11000100100000000101000000101
10010001000000000000010011101
10001001110000100000100000001
10011010110100010000001010101
11000010000001000000000010001
10110101000000100000110100011
11110001010001100010000000101
10001000000000010000000001001
10100001001010101001101100011
10010011001111000000001010101
11111111111111111111111111111
