111111111111111111111111111111111111111111111111111111111111111111111111111111111111111111111111111
1000000100010010001001000101000000000000100010010000010001000C0000010000100000010011010001000010001
10010000000000C000000X00100000001110100000101000000000000100100000001100000000010110011010100010001
110000000010000000001000000000101000000111010000010101001000000000000001100010000100000100000101101
100100100010000001000011000010010001000000C00101000000000000000000000010000000110000X00001100000001
100000111000000000000010000110100000100101000000000001001000000001000000100010100000000000001000001
11000000000000000010011000X001000000000000000011010000000000100000000100000100010000001001010100001
11000001001000C0000010000000001X1001000100000100000001000010000000000011010000000000001000000000001
100000000100011100110000010000000000110100001100100000000010000000011101010000110010000000100000001
101000000110000001001001010010000000000000001000001000000000100000100001001101000100001000000001001
1000010000000010100100100010100X0010000000000000000100001000100001100000000010000000011001000000001
100000001000010001000010100000000001000101101010001110101000001000010100000000010000000000000000101
110100000000000101010110000000000000010110100000010100000001000010000010000000000000000110010000101
110000000010000010010100001010010000000000001000000010011101001000000001100000000000111011010000101
100001000001000001011001000011000000100000000000000001101001000011000000001000100000010000110101011
101010100100000000000011000010000001101010010011000000110100001000001100001010001000000000011010001
1010011011000C0001000000001000100110010000011100000100101010000000000000000010010000000000010000011
100000001000010011000001110011000100100101000000010000001000010000011000000100000010001101000010001
101000011001000000001000000000100000001010100000000000000010010100010000100000010100001001001000101
101000000000001110010000000000010010000100100100010000100000010000000000110000010000000100001100101
110000000010000000010010000001000100110000000011000010000000000011110000000100010111100010000000001
100001110000000100001000000000000010000100100000100110000010000001000101000100001000011111010101101
100001011001000010001100100100011010001010100000000000000000000011000000001110010000000001000000001
100111000000100000000000100000000000011100000000100000001000010000010101101000001010010001000000011
110101000001001010000001000001001011100001000000010000010111010000100100001110000000100000000110001
110000000001000000010001011000011000010001000010011000001000000000101100000001001001000000010000001
100000000000011001000000000000100100000000000000010000101000000000100000010000100000000011000000001
110110000110001000000000000000010001000001010010000100100001000001100000000001000010101100000000011
100011011110000000000001001000000010001000001001010100001000000001110000000000000011010100001000001
100010100001000010001000000001100010000101001000110100100001010000100000000000010011110000000001001
101100000100110000001001011000000000000100000000100000000010000100000010010000110010000000000000001
100100010000110011001101000000000011000000000000000000000110010000001110000101010000001000101011011
100000100001010110000000000000000100000010010010100000000101000001100000000011010001000000101010101
1E0100010100000010000000001000000010111111001100000101010010100000000110011000100000010001100000001
100000000100100000001011100000010100000100010110101000000000100100000000010000000010000001101000101
100P00100010010010100010000001000000000011100000001000000001100101000100110101001000101011000010001
10000000000000000000000X000000000000000000000000000000000000000000000000000000000000000000000000001
111111111111111111111111111111111111111111111111111111111111111111111111111111111111111111111111111
