1111111111111111111111111111111111111111111
100001001C010000000000000000000000000000001
1000010010010000000000000000000000000000001
1000010000011100000000100000000000000000001
1000010001000100000000100000000000000000001
1000000100110101100000100000000000000000001
1000000100010101000000100000000000000000001
1000000101010101000000100000000000000000001
1000000101010111000000011111111111111111111
1000000001000000000001000P000C0000000000001
1000000001011111000001011111111111111111111
1000000001010001110001000100011111000101101
1000000001010000011011110101010001010100101
1000000001010000000000000E01000100010000001
1111111111111111111111111111111111111111111