                  1111111111111111111111111
1111111111111111111100000000000001100000111
100001001C010000000000000000000000000000001
1000010010010000000000000000000000000000001
1000010001111111111111111111000000000000001          1111111111111111
10000100011                100000000000000111111111111000000000000001
10000001011                10000000000000000000000000000000000000000111
10000001011                100000000000000111111111111000000000000001
10000001011                1000000000000001          1000000000000001
10000001011                1111111111111111          1111111111111111
1000000001111111111111111111000000000000001
1000000001011111000001011111111111111111111
1111111111111111111111111111111111111111111
1
1
1
1
1111111111111111111111111111111111111111111111111111111
1000000001010001110001000100011111000101101111111111111
1111111111110000000010100000110111101010100010101001011
			1000000001010000000000000E01000100010000001
			1111111111111111111111111111111111111111111