# **************************************************************************** #
#                                                                              #
#                                                         :::      ::::::::    #
#    010.ber                                            :+:      :+:    :+:    #
#                                                     +:+ +:+         +:+      #
#    By: mhrima <mhrima@student.42.fr>              +#+  +:+       +#+         #
#                                                 +#+#+#+#+#+   +#+            #
#    Created: 1100/01/01 00:10:00 by 00101011110       #+#    #+#              #
#    Updated: 2023/01/05 09:57:14 by mhrima           ###   ########.fr        #
#                                                                              #
# **************************************************************************** #

10110001101010100100000000110011111110011011010001100111000100000011001000111001
10111100010011100000011001000001110100001001001000101110111000110101000010100111
10100000000001100001111100000000101010011000000011110101100010010100100001000101
10010011000100110100010001000100101101011011000010110011101010010100010010110011
10110111101011110000000101110010010000001101110100100101101110101011001000001011
10001000001101010011011110010101100010011000001110101000010101100110001110001111
11110000101011010101110000101110000011001011110101111010010100101101000001001001
10101000010100111110101011000001000011100101101101000100100000011000011000101111
10010100101111001100010101001111100100110010001000100001000100111101101000110111
11111010100001100111010001010110001011010110010000000111010001010110001010010011
10110001101010001111001000000100101011001110011010011001101111101100010110010001
11101000001101100100001111110001001100011001110101000000001001000110011001011101
11001000001010001110000110101000100010001101010011010101100000100100100010011111
11100101110001111110000000001001011101010111110000101011100100100101111010100011
10001000101101001000000101100010101001010010001001001100110000010111110110000001
10101001110100100100000110101001011000110111100010001101010111111110010000000101
10101001001111101000010001101110000101000110001100100101011100100101101010101101
10010000110000101001011000110000001111101111100110101000101100000110010100100111
11000000000101011010101000001000010100000010000011001111000111100001000001001001
10101000100100100011101010110001011110000101101010101101001010110010010110100001
10010100101111001001101110000010101010001010111100011101010100000001111101101011
11011101001110011010011110010000101001000000100010110001100001000011001000101101
11011111110101010111000001111010101010000111010100101011110110000011011010001001
10010100011011101000001000001010100111110101100011110010110001110001000010101011
10010001110101101000000110111100000001010000111101001000100111000101110101010011
10011001100001101010000100001110011100010110101100000010000010000000000000000011
10101000011000000101110001000001011110010000011010010111010000010100100001111011
11111111111111111111111111111111111111111111111111111111111111111111111111111111