1111111111111111111111111111111111111111111111111111111111111111111111111111111111111111111111111111
1000000000011101100000000000011000010000010000001001101000011100001100110000011001001010110000010001
1001110101001000010000010100010000011100111000110000100000101001000111101100100100010101010101000101
1101010000001100000010000010000100000011110110111010000000111000000101011011010110011100001000110111
1010010010010001110100100110010001000000101000011010011100000001011010000100000110101000010000000111
1000000000000010010010011001100110101011100000010100000001100100000001010010001001001000100010100001
1001010001100100000001100000001100010110001000001101111000000111000010001000110101101111001111000001
1101000101100001000101110000011010000000011000100000101000011100000010100000111100100000100011000111
1010001010100010100000010100000000100011000001010110101001001000001000000010001101100100000001000001
1000001011000000111000010111001010000000100000010110010101010000010010010000100101000000111100000101
1110001001001100010110010100110100000000000000000000000010101000000001000000000000010010100001100001
1010000000110101001100011001100000010111001100110000110000000000100100001100000100100001001100000001
1101011010110111000000110000001000110011101000001000110000001000110001000100011001000100000110100001
1101010111000000011010011000000100101001000001100001011100010000000000101010000010000011010000101101
1101011001010000000000001101110000000000001101000100100000101000000011011001010010110010111111100101
1100010100110001000001011000101000000011000011001100001111000000000111000011001000000110011100000101
1000110101000100111010000101101001110000100110000101100000000010000001000000011100010011101010010101
1000101000100000010010100000001100000001010100011001000000000000000000000000101100100001110000001001
1001000110010010100100010111100100110010000000100100101001000000100101010010100001000100000000111101
1000010001100100010010001000011100001100001001000000011001000001011010010010000001000000000100001001
1001010110010100000000100010011100000000010000010001001000100010100000110100100001101000001010000011
1000101001000101010000101100010000110111001010000001110010001100100001010100000000011000010100100001
1001101000000000001000001000001110010001000101110000011001001111010000000010011100010001010010000101
1101000000100101000000001010000000000000100100110000001010101110101100010100100000010000001001010001
1110001110000100101001100101100000000010010010000001000100100110000110000001011000000010110100101001
1100000110100110010001010101001100011011000000000000011100011011100010101000000011100010100000100001
1001100001011010010010001010010000100111110011011100010101000001100100100000010010101100110000001011
1010011100001000000010100010011110011000000000000001101000000100101000001000010000111110100000010001
1100001000001000000010100111110101000000000000100100001010100001010010010110001101000100001001000011
1010001101100000000000000010001110100010100000101101011000000000000001001110101001110100111001000011
1100001000100100000000000000000010100000001000001001001110001100100000010101000010100000000001000101
1000001001010011000101100000000001010110001100101000100000010000001000100100000100000000100110100111
1100011110000000010101000011001000100001000000100000000110000001100000000110101000000000001010011111
1000101001000011000010110001001111011100001011000010000110000000000010001010000000011001001000101001
1011111000000100000000000100000000000010100101001001000101011001100000101001000001010100100100011001
1101111100010000010101001001001001001010001001100010110001110011000010000011100000111001000001100001
1101000110110001111000010000110101101101001100001011111000010000001000000000010111010000000011000001
1111111100110100101001000000001001000111000110000010010000001001110011001101101101001011110000011001
111E011001001101110010100000000000000010100100000000100000000000111110000010000001000000000000011101
1010000001001100000110110000000110001011000000000001000000001001010100010000101001010000000100000101
1010000011000101010010000111010000111000100000010100000001000100000101001010101001000010111000110101
1110100010111001000001100001010110101100100011010000010100001000010000011100011000010001000001001011
1001110001011010010000010000100111101100010010110001101001010100010111000111011100011001011000111001
1100000010000000000101101100100111000100110001110101110010001011010000010000000001001000110001001101
1000P10010001100010110001001001000000100100000111000110000110010101000001110001010010011010010000001
1110000010000100000000010101000000000010110110011100101110001110100000010001000011000000101100000001
1011010011101110000001100001010000010101011100100111000100010001000101000110000101010000010100000111
1010001000100000011011000111001000000101000110110010000000001001000110010101100010000111110011100001
1100000101001010001010011100001100010101010000010010000000110010000001000010100000100000100111000111
1101010000001000100000100110000000000100010010000010010100100100000001110101100010000101001110100101
1000010010001000000011001000000000101000001001010001010001110101100100010011110010010010010000101111
101100000100000100100100010110010100C010010010111000001101010100000110101100000100001010011001001001
1000101100000101010001010110011000110101101001110100001010110010100110001011010111101000100000100011
1110000000110101011011001010000010100001101001000010100010000010111000001000010101101000010010101111
1000000000001110000000000101010100010010011100100001000000000001000000000000000100011100001001010001
1101011000010000000010000010010001001000110010011110010000110100000000010000001000001010110011001001
1001100000011010001100001000100101000010011001000001001011101001110010001101110110001011000011110111
1110010000111000010100000001010001000100000000100110010010010011001100001100110011010010110010000001
1000001001011000000000001110010100000111110010000001010000000110111110110100000010010000000100001001
1100100001101000000011000000011100100011100101010000001000000000001000000001000101000001000010100011
1100001010000101100111110010001000000011010000111101101000000110100000001110000100101100000100100001
1110101110010000010001001001100001101000001000011000100000011001001011100001000000011010011001101111
1010110001000110001000001100100010111111001110000100001000000100000000100000111010101010100000000011
1000101110001000000011000010000011100000100100001000100000100000010010010010000001001001110001010001
1000100011001010101001001010000110100000100100000000000100001000100110000100100110000000000110000001
1101000000001001100011000110000110000010000000100111000111001100001010101000001010101110000100000001
1001100001110001010000001110000000111001000000001000001011000111001001000000000001100100111000010101
1110000101010001000110010100000100000100010100101000001110011111001110000000100100000110010101100101
1001010011001110000000000110000100001010010000001101010000001100101010100010000001110111001111110101
1001001001000000001010010000100001001100100110011011000000010110110000010100000000100000000010110101
1000100100000110001010000001000010000111001001000100100100100000100101011111000000111000010101100011
1011100100000001111000000010100101000000011001001100001100101010001100000100001111010000111101000001
1000111010011000001010011100100010001011000000100010001100000011001100001100000000101011000100111001
1010101001000001000010001000111101000000111110000011001000101011001001000010011000000001000100000001
1001101001010000001011100101010000010001100001100000001010100100000000011101000001100000000000111001
1110001001101000110100100000000000011101011000000000010001110001101000000110001100000010000000111001
1000000000000000111000101001000100000000010001000000000001011010000010010010110011011011011010010111
1100110000100110110010011101010001000011010100110010001000000110001000100001100010000101001010000011
1001110011010011010101111111000011010100001010011110001000101000111010000000100011001100000010010011
1111111111111111111111111111111111111111111111111111111111111111111111111111111111111111111111111111