11111111111111111111111111111111111111111111111111
11110001000010000010010100000000001000101000100001
11001010000100010011010100010000010110000000000001
10000000101000101010000000011000100001110100110011
10100000000100100010100000100000001101000000000001
10000010110001110100001000001001000101000010000011
10000010101000000100000010100000000010001000000001
10010000010000100100010100100000000001110001000011
10P01010000110111100110101101000001001000011101111
10000010100001000111100001000000110000000110011001
10011101010101100011000011000111100000001010010001
10100001000001001011000100000000101011001000110001
10000001000100000100000000001010000011001011110001
1E100100010100001011100011111000001011001011100101
10011001100000010100010000010101001001000001001001
11001000000010011001011011011001000110101110100011
11001110011001010100000110011001000010111101000001
10010010010101000110000001010100000011100011000101
11001001100001111001100000010000000001100110101001
1000C100101001101011110000011000110110000001010101
10001100100010000000100100100000011000001001110111
10000010111000000101100001001000101000000011011001
11100101000010110100100000110101101010111100110001
10110000001001000010000100000000111010101010010001
11001100011001100100001100101110100100010000000001
10101010011000111000001100010010011100000001000001
10110001000010110000100000100100000000011001000001
10010110001010000110011110001010110000001010000011
11000110100010100100001111111001000100100001110001
11011000100101000110000000000110010100010110000101
10000010100100001000110111101000000011101001011011
11000110100010011111001000000010100010100100001101
10010111101110011110100000011001111000110110010001
101100110C1000101100000101000001100000010100110011
11000000000010001001011100100001000001110010000011
10000011000001011001100110001001101111000101011011
11001100101000101001010100010011011010100110101101
10111011100111C01100010010100111000110110101001101
10001000000000000101110010010101110011010001101001
10110101111100110000000111010000010011101010101001
11010001001101000000001000000001110100110101010101
10111000101100011111100000111110000111000100111011
10000100100000010110001111000111000001101011101101
11111000001110000001001000001000100111010001111011
10001010000100011100001100010110010000100101010101
11100001010111111111100110000100111101111000000011
11011011100010000000110100010010001101010001010001
10110001000100010111101001111001010001100000101001
11011001010100000001100111011001010111110001111011
11111111111111111111111111111111111111111111111111