11111111111111111111111111111111111111111111111111
11000000001110011110101010101000010010010010000001
10000001011010000001010111100100000000101001000001
11000001000010001000001001000000100011010001110001
11100000001011001110100010110000001000000100000111
11000000010010110101001000000000100000001100000001
10000011110001001111000000000001000001010000001001
10110000010000000000010000010010001000100000110001
1C101111111000000100000110111000001000111100000011
10011000000101111000010001010000111101000100100001
10010100110100001000000000000111011000000000000011
1001C010000000001100000000100000000000000100000001
10100010011010000000100101100000000001100000000101
11000100000110010000011000101000001010010001101101
10010000110101000000000011010100000010001011100111
10P00111000000010110111000000100000000101000000001
10011110000010011101000010111000001010011101001101
10100000010100000001001111001100001010100100001111
10101100001000001000000111010010100101000100100011
10100110100000100100001000011011100100100011000011
100011C0100001010100001111100010001000101001010001
11000010011101010010110100010001000100010111000101
10000000100110000100100000000011001111000100110101
10000100111100010100001001110100001011001100001001
11100101000100100011001000010011010110001001000001
11111000001101101000000110100100001001111010001101
10111110001010100100010100010001001000011101010001
11010000011010100001011000000001110101010101010111
11100111110100010100011000100000011100100001001011
10100100000010000111100111000000111001001000100001
10101001110110100000101110110000000001000010001011
10100010111111000111100001100010100001001011100001
11001011110000111101001110001000000001010000101111
1000110E011010000100101010110011110100100100111011
10010000010100100001001111010100110101100011111101
11001011110000111101100100101101111111100110001101
11001000000001100001111100101000000110100111100011
10001001011101110100000100100010110001000000101001
11101000000100111110101000000010000110000010010111
11101101110110100010111001101110000010100011010101
11100000111000100011001100100110000010101010000011
10000110001001101011011000001110001000000000101001
10101111000000101101111001100010100110100101010101
11101111110100010111101001001100110000101111110001
10111101101000110100001010001010000001010001001101
11101010100000110100100100001010110110110000000101
10111111110001100000101011001011110000110010110011
10110010111111100101000110101001000011000111110001
10000011100001000011100001110111001000010010010001
11111111111111111111111111111111111111111111111111