11111111111111111111111111111111111111111111111111
10100100001000011000011010100111011010011010010101
11100001001010110000000000100100010001101001000001
10000001100010000010000001101000000000000000000011
11001000100000011100000010010000100000000010010111
11001000000010001000000000100011100000000000010101
10000000000001000010000010100001000110001101101001
11101011000100001100001001110001101000001000001101
1C001010010001010010000010011010000000010000000101
10010000000001000000110000010101101010000100111101
10000110101100000001100111101100110000110010001001
11C10100001001000001010100010000001011000000001011
11000000000000000100010100001010010011000100001001
10001000110100001010000010101000011100101000010001
10010000000000100000100000001100000000111010101001
1P001001101101111111011000000000101000000010111101
1000C010110001001001001000100001000110111100110111
10000001110011001110100110101011000001010010100011
10010001110100001010011111110000001011110011111111
10011011000101010011000011000000000000010000001101
10110100001101000001101001010100110111110000100111
10101001110101110010011000000101000000110101010011
10110E11001000111000001000011110110111100000000001
10010010010000100101011011011110111010000100001101
11110100100101011000000100100000100111011000101011
11000100001001001110010011010101110101100101111001
11100110101111000011100011010110011011010011010001
10010011110000000101101000100010100110101101111001
10000001010100010111000010010000110001110100011011
10001101100010100010101110111011111000110111001001
10011010001111110011001101101000101100011101010101
10010100010000000010111111010011000111000010010011
11001011011011011101000100001011000110110100101011
10011101011000100110010010100101000000110000001111
11010111110001010101100000001100100101100001011111
10001000111100011001000101011110100010010011000011
10011111101010111000010101011100101000100100001111
10010000000000001000010010110110000101110010010101
11001000010101010000101000001110110011100001010111
11110010011110100001001100000110001011001100000101
10000000111100100110001000000000100110011000011011
11001110000001110001111111000010011100010000001011
10111101101110000111000000000000110011111010100001
10001011110101011011100011010100100100100011110001
11101001001110000101110100010001010100110111001011
10100100011110001100001001010100000011101011110101
10000001111000100010001110001001011100001100011001
11100101000001010101100100111101000110011001110001
11001010010100110000011111100000100110110100001001
11111111111111111111111111111111111111111111111111