11111111111111111111111111111111111111111111111111111111111111111111111111111111
10001110000000100001000001000110001000100101010110000000100001100010100000000011
10100001000000011000010100010001000100000010110100011000001010001010011000100001
10000000000100001000100010111001100000111000000000000010000000010011001000010001
10000000000000000110000000000010110000100010100101010001001110100110010001100011
10100001100000000000001100100101101000100010010001000001000100001000010010001001
11000001110000100011011101100110000100100000000101001001001001001000001100011101
10001000000001000000101000110011100011001001100001010001000110110100000101011001
10010100011001110000001010000110010000010100001000100000100011001000000100101011
11000000000001010110010011011000101001100101001000001010000000000001001001000001
11010000000101100001001001101000010000000101010000001001000000001010010001100011
10001000010001000000100001000100100001100010101001010000000100010100000100000011
10000000001000100000010100000000000000000010011011010000001000111000001010000001
10111000010011101100010000100000100010100101000000100011001011000100100010010001
1100010000000C001011000010011000101000010100100000101100000100000001010001000001
10101111010000000101000100101100001111000010001000000100010000000000000010000011
11010001000000001110001101000000000100000000000010100101011001000000100001000001
1100000110001101010000001001001000000010000C000001100001000010100001010001101011
10101100000100010000001000001101001010000001110000000000000000100100010100001001
10000000010100010000010000010101101010010000000000000000100000001010001001000001
10111000011001100010000101000001101011010110100010000000111000110010111001000011
10011000000000100000110100010000000000000000000010000000001110010001000001001001
10100000101011010100001000100100110010001000110000000011111011000000000100000011
11010100100110000111010000110011101100101000010101001000010010110011000010010011
10011000000110110011000C00110001001000001000000101000000000110010010000001100101
10100010000101001100010100101100010000000100010010001011000000000000010000000101
10001100000000000110001000000000100000000011000100010010000100100100001000000001
10101010000010101001000000011010000000100101001001011001000110010000001110010011
11100010100010110000010000000100011000101011000100100010101110111010111100001001
10001100010000101001100100100000001000100000010010000000100001100001101010000001
10010110000000100010001000000000000011100010110000001000100001010110000000000001
11101010001001000001010000000010001010000001000001000100010000111110011011010011
10100110100000110100110011000110101000000100001111000110010100011001010001000001
11101100000010001000111000000000000001000110011001011000000011010001001001001001
11100000001000001000001100000000000001110011001001111000000000000110111100110101
10001100011001100000101000000010000011000000010100001110011100000100000100100001
11101010001011000001000000010000101001000000101000110110010101000000010001001011
10100100000100010010000010110010111100000000010101010010001011011110101000000101
1P001100100010000001000110100000101001000001100000010000000000010110100100000101
10101100101000001010010000000011010011100010111011100010101001110011101001100001
10000100000000100011010011000001111000010000101000111000000000001110000010100011
10101000101000000100001001010000010000000011100100001000010101100100001111100111
10100010000000101100110100110001001000001001011000010000101010100010100010011001
10000101100010011010000001010011010011001000000001000111010000000001000101001011
10001110000100010010110001000001011111000000100101101000001000001101011001111011
11011100000100010101000000101110000110011111101110010101000110000001000000000111
11100001000000100101000001101001100000001100001010001001100000100000000100000001
11001000000001000011001001001000010101001000010101100100110000100010000000100001
11000100001000001000001000000101000110001001000000100101011010010110110011010011
10011010100001010100000011000000100000010000011001000111010011010000000100100001
10100000100110000000100101011001010101100010000100100001110000000001011000111001
11001000111001000100000010001011010011001000011010000000001100010010000000000001
11000011000101000001001000101000111000000100000001000000101110011010101010000101
11000010000000100000101110011001011001000101010011010010111010110011010011001101
10000000011000011010101111100110000000010100000C00010001000000011100111000100011
10000000010000000000000000000110011011001000111100000011000100001001110101101101
11001001100000000000010101101011111100000001000010110001000010100010000101000001
10010010111010000100000010101001001101010000000100011111101101110000010001011101
10010000101000100001001000000110100001010110000000110001000000000110100110101111
10100000111010100000000001000000010010000001111010010111010001001000010100011001
10011000100101011000011000110111110011111000000001000001100010001010100101010001
1010100C100111101100000111000110000000000000000001101101100010010101100011010001
10000001001000100110100011001100000000000010100101000100101100000001010100011101
1E010000000000001001100110000000110000101101000000000100001110101010000011110011
10001101100001110011011101000001000011100011000000001110000100000000111000001001
10100001010010010101000000010001011100100010110010100010000110011011011100100001
11000001000111100001010010000100010010010000001110011000111101010100000010011001
10000010001100000100110100001100110110100011000000010111000000011010100101100101
11100010010000000001101010000101001111101010001010001100011011001100001110100001
11010101000011100001111110110110111100001010101000000100100011011100010001010011
10000101011101011110000001001001011000111010000100000000001000100110111000000111
11100110010101011000101100000000101111011010010000001010111010001100110000001001
10000101001111001001101000001010010000011011011001000000111101000000101000101111
11110000000000100010011111010010101100011100000110010000001001011000000010000001
10101110101100100100011100001010011010001010001010011010001001000000010110000011
10110100010011101010000100101010011011000011100001000101100000000101001010110001
11011001001100000110000011010010010110000000000001000111001000101010011000001001
11001100100101100000001100100010110011101000100000011010111000010000110000001111
10111110000101101011000001100110001101111101000000000011101111111000000000000001
11111111111111111111111111111111111111111111111111111111111111111111111111111111