1111111111111111111111111111111111111111111111111111111111111111111111111111111111111111111111111111
1010000111001011001100000000100011000000000000000100001000000001010000001111010000010011010010000101
1000000001000100110000000111110000000000000001001001100001000010000000100001000000010000100010000101
1000001000001000000000000100000100000010110100000010000000100010000000010101000010001000000000000001
1001101000001000010100000001100010100000100001100110001001100000000010001001101000100100000000010001
1000010000000010010000000100010000100000000011001111000110010010101000110011001000100001000000000001
1E01000000101000000010100001000000010000011000100010010100001110000100000000000010000010000000100001
1C00011100001100010000011000010000100000000000000010100100100000000000001110101001000000001100010001
1011100001110101001000000000000000010010101010101010101000011000000100000001000000100000000001001011
1000011010000010110100000001000000001000010100000010011000011001101000000001000010100000100101000001
10000C0010100000011101010000000010010010100101100000100101101100000011001110010100100000000001100001
1010010010010100011000010000000011001010000111100101010000010010101001010100100110000010111000001101
1001101000100000001101010000010001000010001000001000101000100101011000011000001010101000000101100001
1P01100010110000011001001101111100010000100100001101000111010001010000101000010000100011111000000001
1010001110000000001001001001000010000001000001000000010001011111010110000000011000011110000000000101
1010000110010111001000101001111110110010011011010010110110000000010010010000000001000011110100000011
1001101111010000101001001001100100100000110100011110010100111111000100000000011001001110100100101011
1100110010000100100111011110100101100111101110100101101111111111011010101000111000101010110111011011
1010110100001110010010000101000011001100101000100111011001101001011100100010010000010001011010011101
1001000000100110000011001010110011101100110001001001010010100001000010100110011100000100000101110001
1000011001100100011010101011011101001110000001110111100000110010101100010000010111101010101000001001
1000000011101010110001011001101010001110100000001000000001100000000010011000001110110010010011101001
1100001111100000011001010001000000011001001000010001110101110010100001010000001010011100000110100011
1000000000001000101101011110000110000011010000000010011100001101010100111110110111000110000001101101
1111000010100000110011000101101101000000000111101110111011010001001000000100001000001011011010100011
1000111100001110100000100110100010000001010000010100010011001001110100100011001000110001011000000011
1111101000010100100110011101101011110100110110111011010100110101001001110101000100011010101110111001
1001000010111101001101011011000000100000101100010000001100100110000000000000101111100101010110000011
1011100100000000111100001000101000011000000001101010011100000000011010101010010110010001111001111001
1001101100101001011010101000011111110110100100010010000001111000010110000111100111000000110000110001
1010010100101000101001000011101110010010100101000100111001000100000000011011000010000000011001110011
1001110110001001101000010101110000110000001100000010100010101011000010100010000110100100010000010111
1000111100011011110011000100110111011111000000001001010101010100001100000000011000001110100001001001
1101010011101101000100011111100000000100100011010001010100101110001000010000010010100011000000100001
1000111110011010101110011000011001010110101100110010000101000101100001000010000110001001010000000101
1110110010000000011110100000110010000100101001001101110000100110011101000100000100100000001011111011
1000100101001110001010000011000000000100011010000000000001010111010010101100000001000001010001010001
1000111110001011000110001001100011100110010110110011110001100111010001000100001010010001010010010101
1101111101010111111001011101101001110110011001000000011100011011110001001100100010100010011000001001
1010001000011000111100110100000111100010100111101100110010101000010011100000000010001011100000100001
1010000001000000000101101000100011100000011100001100110100101110000001011011001000100010100111000111
1100010111100000010000000001000010011100000101010000100100100110000101011110110011000010011010001001
1001001100000011101101011010010101010101001000001100010111110010101110101100000100000011011100111001
1110000010111000100010001110101000001000000000000001000010000011000010001000001110101000001100011111
1011100000010111000111001111000111010100000001100001110001001010111010010000010010010111000100011001
1101000110001110111101001011000000101000000001100110000001010011100111011100000101101111101001010101
1001101100000000111111110010011001101010010011011000101010001111010100101111111111011110010100100101
1011010100101111111000010000000100000010010000000100100100100010010101100011100000100010001001011111
1000001010011100111101110101010001100001010000110010111100001001010100000001100100000010000010000111
1001100001011000011100000011100100011100010001001100000000100010000001000000000100010100100001001101
1101011010100000101110000010100010001000011000010000001001000111100000000010001011101001100010000011
1010101000010000000011100000111010000100000000011010000000100001100100010001000111000001000000110011
1011111001010010100000001101010001000100100111010111101001111101011000001010110011001000101010001011
1110100010000001000001110011110110001000101000000001101101110000011111111011110100000000001100011001
1100111010111000101001101000000100110111000011110011111010000000100110010010000100001000110101100101
1110000001110000100101101010100000001111001000010010000101111001100011010110010110111101101011100011
1000000001010101000000011011000000110001100011010010100011010001100110001110110001001110001101111011
1000000000101100100011010011100000110100011010011101000000001011100010100010110010111101100001110101
1111000101100000100101110101010110010010100110001000101010001011010000011000010110101010010000001101
1101000101100110100010000100000011011100001010000110010000010001110001101101001001110000001001001101
1011010010100000000010001000000100000000000100000110100100010110001010010111101100101101110101111001
1000001110000110110000110100100101001000010000110001000101001110000000100110000001100000010110100101
1000101110101001000110101011110000010000011101000101000001000001000000011000110001100010010000000111
1010001111100100001101000001101101100100011010000010000000001001001000111000000111011001001001011111
1000001110100110010001100010000001100110100001000110100000100110011010000010001000110010011000000001
1010011000000000000011000001001100011101001101000100001011100010111101010000100110100100001001101111
1110000000110000110001000001100101110001000010100100101001001010101001001011111100011000011001011111
1000010001101100001010000000100000110000000101100111000001100100010000010001110010001100000000010001
1100100000100111000001011000010100001101101010011100100000010010100011001000100001011101000000010001
1100100010000100001110100100001110001000001000010110010100101001111110100001001101000110111100110011
1011001011001100001100101100100110001000011010000010000100100100010001001001100010010000011110011011
1111001101010001000000010101010000000010001100000010001000101001010100000011100100000110101101011001
1100000111110101100101000101100010000110001010111100110001001011001011010100000010000000010110001011
1010010010100011000010100001010000010111110101010101000000101111010100010001010011001000111100000111
1000000010001010100101010100101000000111010011001011001001000000001111010000010000111001000001010111
1010001111100111001010100101101111100111111000100010001010101000101000110000100100000000111010100011
1111100011001100101011001101000110100000101101100110001111101100000000010001000110011101100011101001
1000101101000001101000001001010010000000001001101001101110000001111000111101110011011001100001100001
1011111001111101000101100100010100100001101000111011010000011011000100001000001000000001001000101111
1011101111101011000000001010101001001000101111110010101011000110000111101110111000001000110100000011
1111111101011100010011010011001000001001100000010110001110111010000110111000011101101101001010101001
1101011110111010101100100000000000000001001000000111010111000100100010111100001110111010001001011111
1011110010101010000001011100011001000110000110101101100100100111001110101111101111000000001000010011
1101011110010101100101111100001000100000111111101100010111000000100101111001001010000001001000011001
1011000101001011000001111101110011011100000011100111000100001011001010010110010100001010010111010001
1011000100001000001000010010100001100111011100100000100101010010011000100111000101101010100010011111
1000000110011010010001101111000110000100101011001101010100100011110011000001101101101010010000011101
1111101111011001010100010010000110000001101010001001110100110101100001100100000000100000011010101011
1001100000010110011001000110010111010010000000110001000001000000100110000100001101111000101011001001
1001011011010100101000001000111100000100011110000011101100000010000010101011111011110000100100111011
1100000001001000101011011001100011101001000000010010011010011100100101000001000010110011011000110001
1000000111001101111110000100000101100110011110100110001000000100000001000100100001001011010001110111
1011110000111101001000010101000101010100110111010010100111001011101100100000001011001010000111000101
1001010001100100000100010101101000010010101100001001000000000100010000000100010000000010001010001101
1011100001001011001101100100100110010001010111000000000100101001100001001000011000001001011010010001
1000101100000011100011000011001101011010101111011010100000100100110011100000001001111000011100000001
1011110000001001100010001101000010100001000110101011000101000011011011000001010010110001100111001001
1011100101100110101111011100110001011000010000111111100000111001100000010001001011011000001001100111
1000000100110000101110010000000101100100000010000000000110000100001110011010010000110100110111001101
1111111111111111111111111111111111111111111111111111111111111111111111111111111111111111111111111111