1111111111111111111111111111111111111111111111111111111111111111111111111111111111111111111111111111
11100P1000100000010100101101101110010000100001000001100111000001110000010000000001100010111110101101
1E00100000000110001000001010000011011100010001110100100100101100000001010000010101000000011000001011
1000111C11001000100000000110000101010010000001100001000010100100001010100100110000111000010110100001
1C10000001010100100010100000001101100000010011101010100001010100100000011111000100010010000010011001
1000C11110111101011011111001100111100011110000000010100010111010011100000010111101001111101000100011
1100101000000100100010010001100001011101011001100001010010011100011000110001000010100110000000000001
1101001110110100000100111111000010110110000100000000101010000001000110101110101100001100100100110111
1101010010000110100000001000011011010001100011101001101110100010001001100010010101100100110010001001
1000010000001000010111001001110000101000000110010001010000000011110010000111010000101100110000010001
1100000C00010011001001011100010001001010010100001001010001000011100000101001111001110101001000000001
1100000111111011101010011100011000101101011010010000101011100000100000111001100010110001010001010111
1100001110100000110110101001110101001000000111111111001100011000000001001100000000100000111101001001
1000100011111010100110100001101101000001010101000111001000110010100000001000111100111010101100000001
1100101010100010110111101000100001011001001010100011010000101011000111000111001110011010000001100011
1010101100001001111010011000100110000000001100100011000011000000100001011001110101111101110000000101
1000001101001100000111100000001000110010001100010000000000111000011100010001100100010110110000001101
1001001000100001111000001001001000001010001110001100001011000011000100110100000001000111111001001101
1011000000100101001000111101000000110010110000000000100111011010000000110110111100111111110000100001
1011110011001111111010010100000101010110001001101000100010001001101101000000010000010000011011011111
1101000000000000000111000010000101100001000100010111110000100010011000110001011000011001101001010011
1011011011000000110001011000100111110101010111001100011101000110110011111010010010011011110000110011
1000001001001001100000000000001010111010110110010000111011000001110101000111000001010010010101101011
1111001011100101000100010101100000111100001000010001101101000000110111101001010100110000011100010011
1111110001001100010110100011100010000101000011000000110111000110110000011000101100010011100000010011
1000000011000011011010000111100101001000100001101001110110000110000100010110001100100000000000001111
1100001111000000000101000100011010111000110000011001100100101000010100000011111101011001011111011001
1000000010010010000001011000001100110011000100100011011100000101001000101010010100011101010100001111
1010000101011010001000011011010000000100011001010010111010000101011010001001001101100100001100111001
1000000010010010010010000100010011001000000111110000100110000100101111111001010110000011000101010101
1110111011001001100101101000010110000000111100001010011000001010100001100000100011000001100101011001
1010001100011110110111010101100100000110001000001111010001100000010100001000101010100100000011101111
1111000001110001000100110000010000010101110001001011000111101000100110001000011101010000001001111111
1000010000000011101110010001001010000100000100010001100001001111011000000100100000010100011001101101
1100001011000010100000001010010001011101010000010110111110001010010011101010000010100000010100110001
1000001010000000001111000110010111110000011000011100110101001111100001000000100000001101010010101101
1100100010011000011010000011001001010000000011100010110101100000011100001010000011011100000010000001
1111000000000010011111010010001110010000000101110100100000001010010001111010000111010010001101011011
1110101011000010100101011100111101110001000001111000110011011000010111110010110000001010010001110101
1011010001011110001001101100001101110000011001001001100100000001000000101110110001001100011010101001
1101001111111011001000000000110010011000100100100000000010001000100000010000111010111101111001010101
1000000000001110000011010111000110110010000000011100001001100000110000110010110010110010000101000111
1000001101111110001001101000101110000000001100001100100100101001100101011010110001000011010001100011
1001010100000101101100101000101111111000000110100101000010011000010001001100001000001010010100010011
1110101010101001000111111010011000011000000010011001100001000001000000010000001110001001010011011111
1100100000C00011001010010010101000000100011000000011110110101110100010010010001010110001001000010101
1001000010010010101001001010000001011001001001000011111000110101000100101001010100110011000000110101
1100110101000000100000110010110101101001010000011111110000000100100100010111010000011010000001000101
1010110110100000000000000111100100001000011100101001000000000000100001110000100101001000000000110101
1101111100111000011010101000010110000000110000110000110100101010101110000111101100010110010111010001
1000110001011010101000100110111000000010000011100011101001100111100101000011011010000000000011101011
1000001000001011011001000000111001110001010011000100101011100111011111001101000001110111100011100101
1000110001100111000110110001100000110111010000110001001100000101001101000001100000011001100100101001
1011101001100010110100000001011011001010010110011001011001100001000010100101100100001011001000000001
1010000010101111001100010011011000110011000110101000100000010001111100000000001000011010100100101011
1000110111110110001101010101110100010000111001000100111000000000101000000001000011011100001100101001
1001000100100001110001011101000001000001010100000001011000010110011011011001001110001000100010101011
1101100011010010000011010011000000100110011111000110001010100000000011100000001011100010001001101111
1100100011100101011100110010011100010011100010011010111100100110110001010110000101001000100000100001
1000010110000111010110000011001100100000101011101011010001010110111101000111101011010010010010001011
1000100101101001100101010001100001010111000110111011001010000100110000010101000000001001000110000101
1000010000011010010110011100110011001011010011000010001001001000100001010000000000110010001001010001
1110001101000000000000100000110111100000100000010010000010010101010100111100100010000000000100110111
1011101100000010111110000010001001101110010011000110000111000110100110011010100010001000010001100101
1110100100000001110000000010000100110000111110100100100001000000100101011101000001100001100100010101
1000101010111100000000110100101000011100001000111010011001100010100011010010110010010101000101100011
1100000101000001001000010110100110011011010010100000010001000100100011000010010010100110111001011001
1001001000100001111010010011100000110010101000100000010100001100001100010010111100100010000001100111
1001000110001010011111111001101100001001011000101001010011001000000100000000101000101110111101100101
1000000100011001110010101110000110010010000000000011000001110100011110010100100101100000000101110011
1011000000001001100101001011110000010101011001101100110000110000110101010000111110000100101010111001
1000010100011001011101101011010011011000000010010010100000001011101000101111000000110100101101101001
1001111010110000010001000001110001011000010110011001111110101010000110001000101100111010100011101111
1110010100000001000000000000111010001000110000010100100000010010000010100101001101000101011111011101
1111101111101000001010000000110001100000000110001100000001111001000110100110100000111001010011100111
1110000011010010001111100111000110000000000001110100010111010011000011001101010011010100111011101101
1000011000001000001101000110001010010100011100000100100010001101111000101100100111001000100100010001
1100010101000000011100011000001110101000011110001101010010110010000100010100010010001011000001000001
1000101110100110000111000010011011000000010110111100110001011010000100101100101010000000111110101111
1010010001101000101000000001100110000100111010010010001000100000101001100000000011000010100111111111
1010010001010110011100001100011010000000000101100100011100011110100000011010110111010010101000011011
1001000010100100111001000010010100001110000011111110011111110010010000101000100011010101001001100001
1011010110000001000100100001001100100011000100000101100001000010010000101101001000010101000000110101
1000111001011100110001000100100011000010010000010010001101010010101011000001101011000100100000101001
1000100011110000001110010000001001010100100001010011001100110001100100010100011011011001001110001011
1110000010001000010000101011000100110000011100010010010100010100100100001101000000001100110110011101
1010100000010010110000101101101100100000010111011011100111100001000110111111001000100010100110010001
1110001001010100010100011010010010000100010101000100010001101000010100011001000010010011001111101001
1101101111110001010010111010000111100100101101000001111010011101000011101000011000001110001110100001
1001000000000001000110111010101000000100000101010100000001101101110010000001011010100111101001011001
1011101010000110000001100000111010011110010110110001001000100001010001110111110000111010110010010001
1000110101001111010101001011011001100110010001001100001000110100000101001000010001011100110000100111
1000001100011000101000101101111010000110011100000111111001100100110000001011001001010010101011000001
1110110011001011001000110111011010000000000001000010100001000010101010100100011001010111001110001011
1011001000000110101001100000001100000101000111101000100010011100011011010100101000011001110011000001
1001010000110010010101110010100000011001000111011111100000101000111010101100110001100100001000101001
1111000010100010000110010111001100000001000011110000000110100110000111111100010101001011000010011101
1100001001100010101101101110110011000100100100010101111010000010111000001100001000000001100110010001
1001100100111010100101100101010011011001100000000011010001111001000110010001011010000101010011001111
1111111111111111111111111111111111111111111111111111111111111111111111111111111111111111111111111111