111111111111111111111111111111111111111111111111111111111111111111111111111111111111111111111111111
100000010001001000100100010100000000000010001001000001000100000000010000100000010011010001000010001
100100000000000000000000100000001110100000101000000000000100100000001100000000010110011010100010001
110000000010000000001000000000101000000111010000010101001000000000000001100010000100000100000101101
100100100010000001000011000010010001000000000101000000000000000000000010000000110000000001100000001
100000111000000000000010000110100000100101000000000001001000000001000000100010100000000000001000001
110000000000000000100110000001000000000000000011010000000000100000000100000100010000001001010100001
110000010010000000001000000000101001000100000100000001000010000000000011010000000000001000000000001
100000000100011100110000010000000000110100001100100000000010000000011101010000110010000000100000001
101000000110000001001001010010000000000000001000001000000000100000100001001101000100001000000001001
100001000000001010010010001010000010000000000000000100001000100001100000000010000000011001000000001
100000001000010001000010100000000001000101101010001110101000001000010100000000010000000000000000101
110100000000000101010110000000000000010110100000010100000001000010000010000000000000000110010000101
110000000010000010010100001010010000000000001000000010011101001000000001100000000000111011010000101
100001000001000001011001000011000000100000000000000001101001000011000000001000100000010000110101011
101010100100000000000011000010000001101010010011000000110100001000001100001010001000000000011010001
101001101100000001000000001000100110010000011100000100101010000000000000000010010000000000010000011
100000001000010011000001110011000100100101000000010000001000010000011000000100000010001101000010001
101P00011001000000001000000000100000001010100000000000000010010100010000100000010100001001001000101
101000000000001110010000000000010010000100100100010000100000010000000000110000010000000100001100101
110000000010000000010010000001000100110000000011000010000000000011110000000100010111100010000000001
100001110000000100001000000000000010000100100000100110000010000001000101000100001000011111010101101
100001011001000010001100100100011010001010100000000000000000000011000000001110010000000001000000001
100111000000100000000000100000000000011100000000100000001000010000010101101000001010010001000000011
110101000001001010000001000001001011100001000000010000010111010000100100001110000000100000000110001
110000000001000000010001011000011000010001000010011000001000000000101100000001001001000000010000001
100000000000011001000000000000100100000000000000010000101000000000100000010000100000000011000000001
110110000110001000000000000000010001000001010010000100100001000001100000000001000010101100000000011
100011011110000000000001001000000010001000001001010100001000000001110000000000000011010100001000001
100010100001000010001000000001100010000101001000110100100001010000100000000000010011110000000001001
101100000100110000001001011000000000000100000000100000000010000100000010010000110010000000000000001
100100010000110011001101000000000011000000000000000000000110010000001110000101010000001000101011011
100000100001010110000000000000000100000010010010100000000101000001100000000011010001000000101010101
1E0100010100000010000000001000000010111111001100000101010010100000000110011000100000010001100000001
100000000100100000001011100000010100000100010110101000000000100100000000010000000010000001101000101
100000100010010010100010000001000000000011100000001000000001100101000100110101001000101011000010001
101001010000111100010100000000000010000100010011100000001000000010001000010010000000010100001111011
100000001001000010010000100010100000000010110010000100011010010001000010001000001001001101100000001
100110001000101011011000000000001011000000010000001000000000001100000000100000000001011000000101001
110000000010101000001010000000100000010000010000110100100001100000000001100110110010000000001011001
100010100000000001100111100000000101100000100100010001000000110110000000011000101000100101110110001
100000000000000000001011000000100001010101000001100000100000001001000000001001010100010101010000111
100100100100000000001010000000100000000010000100110001011000010000000000000010000001000100000010011
100010000010010000001010001100001000010100010110011001000000000010000000000000000100000000110100001
100010000101011000000001111011000000000011000010011101100101000001101001000001100001000100000001001
100001010000110000010000001000000010000001001011001000100000100010110100001001000011010100000000001
101010000001001010000111000011100000010000100000000111010000000000100011110100001010000111001110011
110100001000010011001001000010000101010000000001001010000001110000000000000001000000000100000000011
110000000000010010000000111000100001010011000010001000100101000010001101010100010010000001001000111
100000000000100000010101001000100011000100000000001100011001001001000001101101000000001000000100001
100000001000010100001110000000001110000000000000000100000001010010111101000010011000000100111000111
10C110001011010110111000011110100000000010111100001100111101111010001011111111101111001011000001111
100111011000010111101111110111011001001001000111011001110110010011101011110001000010011111101011101
111101010110110001100011000110011011011110000110010011010011110101001111110111100000001111010101111
111111010011110110111110110010100001010010110011011011011101000000010010111010001101101111110001111
100001111111001011111100010101010001001001001010011111001110100011001100101101010101100011011101101
100110011011110010000111011101101011010001111101000001111100001110011110111110111101010000101001001
101010100100101000010010110110100011010001100000101001000100101111011000110011110100101001101110101
100101000000000010111011111010100110100001101111111010000010011010011101000001011001010111101001011
101110111111101110001100101101000111000100001010101100010111111010000000010000101110101110001001001
101111001111000101100101101010001100110100101011001010000111101111001110110111111000101011001001101
101011010001000010011110110001111110000110101100111111010110001000000101010101001110111100111111011
111001010111011111011101110101001101111010101110000001011111101111000000100011001101001010101101111
111001001101011101010011000010101111001001111010110011011111001000011110011001111110101011011011101
110010011010010101101110011010000001111111101011010111000110110011001010101101101001101011000110011
111110011010000110110111011011111111011110101101111111000100010010011111111110000111110111000011111
111110010010100011111011111000001011011000111101110010001101100010000110111001101110100100110100001
100010010111010101001110010100110100011101110000111111000011001101111011000101110101100100110000011
110011111101100001011111011000100011110101001110011000101101001100111111101100001000000110011001111
110101111011001001010101111100110010011011111110110000110000101101011010100011101110111100100101001
101010001001100000011000100110010000010001111010010000110011000100000010001111000011010011011011011
110111001000101100110101001100000011111001011101000111111111101111110111100100111001011110000011001
100110100011001000100011011011100110111011101111000111100100101001011011100111111011001011110100101
111000100111101011111100010010000101011010100000110100101110101011010110010111011011111101110000111
111100101010011010011111110100110110110000000100110110010011101000001110100001100111001010000000111
110111011001110000000100111110000000110111110000111111011010011010100000011011011110010100001101101
110011110001100110110011010000000111001000001110101111010001011001101111100111010001001001111101011
110101010011000110010111100100000110000111000110110101110001011111011010000000011001011011110110001
111110000100101001010111010001101001101011111000101111100101001110011001110001100100001110111110101
101011000010100000001110001011001000001100000110001111110001000011000101110011101111011010001001011
101100101110000001101111001011110011110111000111100100000101101100111001110101000101011011000011011
100000001100011110011101000001011100010000100011100101011001111000111111000011010001110101001001001
111110000111010101111110010010011010101011100100100000101110000110011110000100000100011011111010011
110111001001011011100000111111111011000101100000111101100110010111011001110100100011000111111010011
111011100110010111100111100100101110001111010001101001000100010100010001110010010010011011111010101
101011011110001100111110010000000110011111011011101111010010010100001011010101100011000111101001101
100100100011001101101011100010110001110101010101101010011110010110001110011110000110111101001101011
100001100100110101100001111000110100100001110001001011101001110011100000100000101010011010100111001
100101101111001011100100000110011110110000001100010110001001110011010110001110111100010000111101011
110110010010011010011110010100011110001011000001011011100111010100010110000010011100111001110011011
110001011100110010111011010110111000001011100110000111001101110010111111000101010110111100010110011
100011101011111001101100001110111001100010011011101101001101110011010100000000010001111000010011011
111000100010011111010110111011111000110011101101110000001011111100011111110101111000010101100101111
100111111010110111010001110111101111011111000000110000100110000110001111111000001101010010111100001
101101010111111111100001001011001010010111001011111011000110111000101001010100101101001101110111101
111110111011000111000011111001001101011111101111110000100010100010100011110111100000001000110011101
100011101111110011001000011111000110110010110101000100011010101010101010000011110011011001110010101
101111010100101100001000000111101100110101111000101000100111000010000101111111011000111101001010101
111111000111001000011111111010100111000011111110100101101000001000101101111100000110111111110100011
111111111111111111111111111111111111111111111111111111111111111111111111111111111111111111111111111
