111111111111111111111111111111111111111111111111111111111111111111111111111111111111111111111111111
1PPPPPP1PPP1PP1PPP1PP1PPP1P1PPPPPPPPPPPP1PPP1PP1PPPPP1PPP1PPPPPPPPP1PPPP1PPPPPP1PP11P10001PPPP1PPP1
1PP1PPPPPPPPPPPPPPPPPPPP1PPPPPPP111P1PPPPP1P1PPPPPPPPPPPP1PP1PPPPPPP11PPPPPPPPP1P11PP1101P1PPP1PPP1
11PPPPPPPP1PPPPPPPPP1PPPPPPPPP1P1PPPPPP111P1PPPPP1P1P1PP1PPPPPPPPPPPPPP11PPP1PPPP1PPPPP1PPPPP1P11P1
1PP1PP1PPP1PPPPPP1PPPP11PPPP1PP1PPP1PPPPPPPPP1P1PPPPPPPPPPPPPPPPPPPPPP1PPPPPPP11PPPPPPPPP11PPPPPPP1
1PPPPP111PPPPPPPPPPPPP1PPPP11P1PPPPP1PP1P1PPPPPPPPPPP1PP1PPPPPPPP1PPPPPP1PPP1P1PPPPPPPPPPPPP1PPPPP1
11PPPPPPPPPPPPPPPP1PP11PPPPPP1PPPPPPPPPPPPPPPP11P1PPPPPPPPPP1PPPPPPPP1PPPPP1PPP1PPPPPP1PP1P1P1PPPP1
11PPPPP1PP1PPPPPPPPP1PPPPPPPPP1P1PP1PPP1PPPPP1PPPPPPP1PPPP1PPPPPPPPPPP11P1PPPPPPPPPPPP1PPPPPPPPPPP1
1PPPPPPPP1PPP111PP11PPPPP1PPPPPPPPPP11P1PPPP11PP1PPPPPPPPP1PPPPPPPP111P1P1PPPP11PP1PPPPPPP1PPPPPPP1
1P1PPPPPP11PPPPPP1PP1PP1P1PP1PPPPPPPPPPPPPPP1PPPPP1PPPPPPPPP1PPPPP1PPPP1PP11P1PPP1PPPP1PPPPPPPP1PP1
1PPPP1PPPPPPPP1P1PP1PP1PPP1P1PPPPP1PPPPPPPPPPPPPPPP1PPPP1PPP1PPPP11PPPPPPPPP1PPPPPPPP11PP1PPPPPPPP1
1PPPPPPP1PPPP1PPP1PPPP1P1PPPPPPPPPP1PPP1P11P1P1PPP111P1P1PPPPP1PPPP1P1PPPPPPPPP1PPPPPPPPPPPPPPPP1P1
11P1PPPPPPPPPPP1P1P1P11PPPPPPPPPPPPPP1P11P1PPPPPP1P1PPPPPPP1PPPP1PPPPP1PPPPPPPPPPPPPPPP11PP1PPPP1P1
11PPPPPPPP1PPPPP1PP1P1PPPP1P1PP1PPPPPPPPPPPP1PPPPPPP1PP111P1PP1PPPPPPPP11PPPPPPPPPPP111P11P1PPPP1P1
1PPPP1PPPPP1PPPPP1P11PP1PPPP11PPPPPP1PPPPPPPPPPPPPPPP1101PP1PPPP11PPPPPPPP1PPP1PPPPPP1PPPP11P1P1P11
1P1P101PP1PPPPPPPPPPPP11PPPP1PPPPPP11P1P1PP1PP11PPPPPP1101PPPP1PPPPP11PPPP1P1PPP1PPPPPPPPPP11P1PPP1
1P1PP11P11PPPPPPP1PPPPPPPP1PPP1PP11PP1PPPPP111PPPPP1PP1P1P1PPPPPPPPPPPPPPPPP1PP1PPPPPPPPPPP1PPPPP11
1PPPPPPP1PPPP1PP11PPPPP111PP11PPP1PP1PP1P1PPPPPPP1PPPPPP1PPPP1PPPPP11PPPPPP1PPPPPP1PPP11P1PPPP1PPP1
1P1PPPP11PP1PPPPPPPP1PPPPPPPPP1PPPPPPP10101PPPPPPPPPPPPPPP1PP1P1PPP1PPPP1PPPPPP1P1PPPP1PP1PP1PPP1P1
1P1000PPPPPPPP111PP1PPPPPPPPPPP1PP1PPPP1001PP1PPP1PPPP1PPPPPP1PPPPPPPPPP11PPPPP1PPPPPPP1PPPP11PP1P1
1100000000100PPPPPP1PP1PPPPPP1PPP1PP11PPPPPPPP11PPPP1PPPPPPPPPPP1111PPPPPPP1PPP1P1111PPP1PPPPPPPPP1
100001110000000100PP1PPPPPPPPPPPPP1PPPP100100PPP1PP11PPPPP1PPPPPP1PPP1P1PPP1PPPP1PPPP11111P1P1P11P1
10000101100100001PPP11PP100100011P1PPP101010000PPPPPPPPPPPPPPPPP11PPPPPPPP111PP1PPPPPPPPP1PPPPPPPP1
10011100000010000PPPPPPP100000000PPPP111000000001PPPPPPP1PPPP1PPPPP101011P1PPPPP1P1PP1PPP1PPPPPPP11
110101000001001010000001000001001011100001PPPPPPP1PPPPP10111P1PPPP1001PPPP111PPPPPPP1PPPPPPPP11PPP1
110000000001000000010001011000011000010001PPPP1PP11PPPPP1PPPPPPPPP1011PPPPPPP1PP1PP1PPPPPPP1PPPPPP1
1PPPPPPPPPPPP11001PPPPPPPPPPPP1001PPPPPPPPPPPPPPP1PPPP1P1PPPPPPPPP10000001PPPP1PPPPPPPPP11PPPPPPPP1
11P11000011PPP1PPPPPPPPPPPPPPPP1PPP10PPPP101PP1PPPP1PP1PPPP1PPPPP110000000PPP1PPPP1P1P11PPPPPPPPP11
10PP1101111PPPPPPPPPPPP1PP1PPPPPPP1PPP10PPPP1PP1P1P1PPPP1PPPPPPPP111PPPPPPPPPPPPPP1101P1PPPP1PPPPP1
1PPP1P1PPPP100001PPP10PPPPPPP11PPP1PPPP101PP1PPP11P1PP1PPPP101PPPP10PPPPPPPPPPP1PP1111PPPPPPPPP1PP1
1P11PPPPP1PP110PPPPP10010110PPPPPPPPPPP100PPPPPP1PPPPPPPPP1PPPP1PPPPPP1PP1PPPP11PP1PPPPPPPPPPPPPPP1
1PP1PPP1PPPP11PP11PP1101000000000011PPPPPPPPPPPPPPPPPPPPP11PP1PPPPPP111PPPP1P101PPPPPP1PPP101P11P11
1PPPPP1PPPP1P1P11PPPPPPPPPPPPPPPP1PPPPPP10010010100000000101PPPPP11PPPPPPPPP1101PPP1PPPPPP101P10101
1FP1PPP1P1PPPPPP1PPPPPPPPP1000PPPP1P11111100110000010101001010PPPPPPP11PP11PPP1PPPPPP1PPP1100PPPPP1
1PPPPPPPP1PP1PPPPPPP1P111PPPPPP1P10PPPP1000101101010000000001PP10000PPPPP1PPPPPPPP1PPPPPP1101PPP1P1
1PPPPP10PP1PP100101PPP1PPPPPP1PPPPPPPPPP111000000010000PPPP11PP10100010011P1P1PP1PPP1P1P11PPPP1PPP1
1P1PP1P10PPP11110001010PPPPPPPPPPP10000100010011100000PP10PPPPPP1000100001PP1PPPPPPPP101PPPP1111011
1PPPPPPP1PP1000010010PPP10001P100PPPPPPP101100100001PPP1101001PPP100001PPP1PPPPP1PP1PP11P11PPPPPPP1
1PP11PPP1PPP101011011PPPPPPPPPPP1011PPPPPPP10000001PPPPPPPPPPP11PPPPPPPP1PPPPPPPPPP1P11PPPPPP101PP1
11PPPPPPPP1P101000001P100000001PPPPPP1PPPPP1000011P1PP1000011PPPPPPPPPP11PP11011PP1PPPPPPPPP1011PP1
1PPP1P1PPPPPPPPPP11001111PPPPPPPP1P11PPPPP10010001PPP100000011011PPPPPPPP11000101PPP1PP1P111011PPP1
1PPPPPPPPPPPPPPPPPPP1011PPPPPP10PPP101P1P10000011PPPPP100000001001PPPPPPPP1001P1P1PPP1P1P101PPPP111
1PP1PP1001PPPPPPPPPP101PPPPPPP1PPPPPPPPP1000010011PPP1011000010PPPPPPPPPPPPP1PPPPPP1PPP1PPPPPP1PP11
1PPP1PPPPP1001000000101PPP11PPPP1000010100010110011PP10000PPPPPP1PPPPPPPPPPPPPPPP1PPPPPPPP1101PPPP1
1PPP1PPPP1010110000000011110110000000000110000100111P11001P1PPPPP11P1PP1PPPPP11PPPP1PPP10PPPPPP1PP1
1PPPP1P10000110000010000001000000010000001001011001PPP10PPPP1PPP1P1101PPPP1PP1PPPP11P1P1000000PPPP1
1P1P10PPPPP1001010000111000011100000010000100000000111P1PPPPPPPPPP1000111101PPPP1P1PPPP11100111PP11
1101000010PPP10011001001000010000101010000000001001P1PPPPPP111PPPPPPPPPPPPPPP1PPPPPPPPP1PPPPPPPPP11
11PPPPPPPPPPP10010000000111000100001010011000010001PPP1PP1P1PPPP100011010101PPP1PP1PPPPPP1001000111
10PPPPPPPPPP1000000101010010001000110001000000000011PPP11PP1PP1PP10000011011P1PPPPPPPP1000000100001
1PPPPPPP1PPPP101000011100000000011100000000000000001PPPPPPP1P1PP1P11110100001PP11PPPPPP100111000111
1PP110001P11P101101110000111101000000000101111000011PP1111P1111P1PPP1011111111101111001011000001111
100111011PPPP10111101111110111011001001001000111011PP111011001PP111P1011110001000010011111101011101
11110101011P11000110001100011001101101111000011001PP1101001111P1P1PP1111110111100000001111010101111
111111010011110110111110110010100001010010110011011P11011101PPPPPPP1001P111010001101101111110001111
10000111111100101111110001010101000100100100101001111100111P1PPP11PP11PP101101010101100011011101101
1001100110111100100001110111011010110100011111010000011111PPPP111PP1111P111110111101010000101001001
1010101001001010000100101101101000110100011000001010010001PP1P1111P11PPP11PP11110100101001101110101
10010100000000001011101111101010011010000110111111101000001PP1101PP111P1PPPPP1011001010111101001011
10111011111110111000110010110100011100010000101010110001011111101PPPPPPPP1PPPP101110101110001001001
101111001111000101100101101010001100110100101011001010000111101111PP111P11P111111000101011001001101
101011010001000010011110110001111110000110101100111111010110001PPPPPP1P101P101001110111100111111011
111001010111011111011101110101001101111010101110000001011111101111PPPPPP1PPP11001101001010101101111
111001001101011101010011000010101111001001111010110011011111001PPPP1111PP11PP1111110101011011011101
11001001101001010110111001101000000111111110101101011100011011PP11PP101P1011P1101001101011000110011
11111001101000011011011101101111111101111010110111111100010001PP1PP11111111110000111110111000011111
1111100100101000111110111110000010110110001111011100100011011PPP1PPPP110111001101110100100110100001
100010010111010101001110010100110100011101110000111111000011PP1101111011000101110101100100110000011
110011111101100001011111011000100011110101001110011000101101PP1100111111101100001000000110011001111
1101011110110010010101011111001100100110111111101100001100001P1101011010100011101110111100100101001
101010001001100000011000100110010000010001111010010000110011PPP100000010001111000011010011011011011
1101110010001011001101010011000000111110010111010001111111111P1111110111100100111001011110000011001
1001101000110010001000110110111001101110111011110001111001001P1001011011100111111011001011110100101
1110001001111010111111000100100001010110101000001101001011101P1011010110010111011011111101110000111
1111001010100110100111111101001101101100000001001101100100111P1000001110100001100111001010000000111
110111011001110000000100111110000000110111110000111111011010011010100000011011011110010100001101101
110011110001100110110011010000000111001000001110101111010001011001101111100111010001001001111101011
110101010011000110010111100100000110000111000110110101110001011111011010000000011001011011110110001
111110000100101001010111010001101001101011111000101111100101001110011001110001100100001110111110101
101011000010100000001110001011001000001100000110001111110001000011000101110011101111011010001001011
101100101110000001101111001011110011110111000111100100000101101100111001110101000101011011000011011
100000001100011110011101000001011100010000100011100101011001111000111111000011010001110101001001001
111110000111010101111110010010011010101011100100100000101110000110011110000100000100011011111010011
110111001001011011100000111111111011000101100000111101100110010111011001110100100011000111111010011
111011100110010111100111100100101110001111010001101001000100010100010001110010010010011011111010101
101011011110001100111110010000000110011111011011101111010010010100001011010101100011000111101001101
100100100011001101101011100010110001110101010101101010011110010110001110011110000110111101001101011
100001100100110101100001111000110100100001110001001011101001110011100000100000101010011010100111001
100101101111001011100100000110011110110000001100010110001001110011010110001110111100010000111101011
110110010010011010011110010100011110001011000001011011100111010100010110000010011100111001110011011
110001011100110010111011010110111000001011100110000111001101110010111111000101010110111100010110011
100011101011111001101100001110111001100010011011101101001101110011010100000000010001111000010011011
111000100010011111010110111011111000110011101101110000001011111100011111110101111000010101100101111
100111111010110111010001110111101111011111000000110000100110000110001111111000001101010010111100001
101101010111111111100001001011001010010111001011111011000110111000101001010100101101001101110111101
111110111011000111000011111001001101011111101111110000100010100010100011110111100000001000110011101
100011101111110011001000011111000110110010110101000100011010101010101010000011110011011001110010101
101111010100101100001000000111101100110101111000101000100111000010000101111111011000111101001010101
111111000111001000011111111010100111000011111110100101101000001000101101111100000110111111110100011
111111111111111111111111111111111111111111111111111111111111111111111111111111111111111111111111111
